0	0	0	0	0	0	0	0	0	0	0	0	0	0	0	0	0	0	0	0
0	0	0	0	0	0	0	0	0	2	2	2	2	2	2	2	2	2	2	0
0	0	0	0	0	0	0	0	0	2	0	0	0	3	5	5	0	0	2	0
0	0	0	0	0	0	0	0	0	2	0	0	3	0	5	0	0	5	2	0
0	0	0	0	0	0	0	0	0	2	3	5	5	0	0	0	3	0	2	0
0	0	0	0	0	0	0	0	0	2	0	0	0	0	3	5	0	5	2	0
0	0	0	0	0	0	0	0	0	2	0	5	5	5	0	0	0	3	2	0
0	0	0	0	0	0	0	0	0	2	0	0	3	0	0	5	3	0	2	0
0	0	0	0	0	0	0	0	0	2	5	0	5	5	0	3	0	0	2	0
0	0	0	0	0	0	0	0	0	2	0	0	3	0	0	5	0	4	2	0
0	0	0	0	0	0	0	0	0	2	2	2	2	2	2	2	2	2	2	0
0	0	0	0	0	0	0	0	0	0	0	0	0	0	0	0	0	0	0	0

