0	0	0	0	0	0	0	0	0	0	0	0	0	0	0	0	0	0	0	0
0	0	0	0	0	0	0	0	0	2	2	2	2	2	2	2	2	2	2	0
0	0	0	0	0	0	0	0	0	2	0	0	0	5	5	5	0	0	2	0
0	0	0	0	0	0	0	0	0	2	0	0	3	0	5	0	0	5	2	0
0	0	0	0	0	0	0	0	0	2	5	3	5	0	0	0	6	0	2	0
0	0	0	0	0	0	0	0	0	2	0	0	0	0	6	5	0	5	2	0
0	0	0	0	0	0	0	0	0	2	0	5	5	5	0	0	0	0	2	0
0	0	0	0	0	0	0	0	0	2	0	6	0	0	0	5	9	5	2	0
0	0	0	0	0	0	0	0	0	2	5	0	5	5	0	9	0	0	2	0
0	0	0	0	0	0	0	0	0	2	0	0	0	0	0	5	0	4	2	0
0	0	0	0	0	0	0	0	0	2	2	2	2	2	2	2	2	2	2	0
0	0	0	0	0	0	0	0	0	0	0	0	0	0	0	0	0	0	0	0
